............................#
............................#
............................#
....####.......#....##......#
............#.......##......#
............#.......##......#
UUUUUUUUUUUUUUUUUUUUUUUUUUUUU
FFFFFFFFFFFFFFFFFFFFFFFFFFFFF
FFFFFFFFFFFFFFFFFFFFFFFFFFFFF
FFFFFFFFFFFFFFFFFFFFFFFFFFFFF